T1 - The 1
TA - The Albatross
TA - The Alchemy
AotGYLB - All of the Girls You Loved Before
ATW - All Too Well
ATW1MV - All Too Well 10 Minute Version
AYHtDWS - All You Had to Do Was Stay
AG - American Girl
TA - The Archer
BtD - Back to December
BB - Bad Blood
BA - Begin Again
TBD - The Best Day
BDE - Bette Davis Eyes
BtR - Better than Revenge
BTtWS - Bigger Than the Whole Sky
TBD - The Black Dog
BS - Blank Space
TB - The Bolter
BDILH - But Daddy I Love Him
BBB - Bye Bye Baby
CIWYW - Call It What You Want
CC - Castles Crumbling
CP - Champagne Problems
CoSoSoM - Chloe or Sam or Sophia or Marcus
CMBSM - Christmas Must Be Something More
CTF - Christmas Tree Farm
CWYWM - Christmases When You Were Mine
CB - Clara Bow
CaY - Cold as You
CBBH - Come Back Be Here
CiwtR - Come in with the Rain
CI - Coney Island
CS - Cornelia Street
ClM - Cowboy like Me
CS - Cruel Summer
DwOHT - Dancing with Our Hands Tied
DJ - Dear John
DR - Dear Reader
DbaTC - Death by a Thousand Cuts
DBM - Dont Blame Me
DY - Dont You
DB - Down Bad
DoJL - Drops of Jupiter Live
ET - Electric Touch
EG - End Game
EHC - Everything Has Changed
FG - False God
FO - Foolish One
FA - Forever Always
FW - Forever Winter
FOtS - Fresh Out the Slammer
GC - Getaway Car
GaH - Girl at Home
GR - Gold Rush
TGW - The Great War
GaS - Guilty as Sin
HS - Hey Stephen
HI - High Infidelity
HG - Holy Ground
HDIE - How Did It End
HYGtG - How You Get the Girl
IAD - I Almost Do
IBYTAM - I Bet You Think About Me
ICDIwaBH - I Can Do It with a Broken Heart
ICSY - I Can See You
ICFHNRIC - I Can Fix Him No Really I Can
IDSB - I Did Something Bad
IFTYE - I Forgot That You Existed
IHIH - I Hate It Here
ILiPW - I Look in Peoples Windows
IKYWT - I Knew You Were Trouble
IKP - I Know Places
ITHK - I Think He Knows
IWYB - I Want You Back
IWYW - I Wish You Would
IA - Illicit Affairs
IOMWIwY - Im Only Me When Im with You
IS - Invisible String
IION - Is It Over Now
INtHaF - Its Nice to Have a Friend
JTF - Jump Then Fall
KoMH - King of My Heart
LC - Last Christmas
TLGAD - The Last Great American Dynasty
LK - Last Kiss
TLT - The Last Time
LH - Lavender Haze
LB - London Boy
LL - Long Live
LLBv - Long Live Brazilian version
LSS - Long Story Short
LWYMMD - Look What You Made Me Do
LS - Love Story
LR - Lover Remix
TLO - The Lucky One
MW - Mad Woman
TM - The Man
TM - The Manuscript
MSOMMM - Marys Song Oh My My My
MiaB - Message in a Bottle
MR - Midnight Rain
MAtHP - Miss Americana the Heartbreak Prince
TMIK - The Moment I Knew
MPF - Mr Perfectly Fine
MBOBHFT - My Boy Only Breaks His Favorite Toys
MTR - My Tears Ricochet
NGU - Never Grow Up
NR - New Romantics
NYD - New Years Day
NBNC - No Body No Crime
NN - Nothing New
NTWDT - Now That We Dont Talk
OtY - Only the Young
TOSotD - The Other Side of the Door
OS - Our Song
OotW - Out of the Woods
TO - The Outside
PR - Paper Rings
APGH - A Perfectly Good Heart
PtB - Picture to Burn
APiTW - A Place in This World
TP - The Prophecy
RfI - Ready for It
SBT - Sad Beautiful Tragic
SB - Santa Baby
SDG - Say Dont Go
SIO - Shake It Off
SSN - Shouldve Said No
SN - Silent Night
TSMWEL - The Smallest Man Who Ever Lived
SotB - Snow on the Beach
SHS - So High School
SIG - So It Goes
SLL - So Long London
SYGB - Soon Youll Get Better
SF - Sparks Fly
SN - Speak Now
SoG - State of Grace
SB - Stay Beautiful
SSS - Stay Stay Stay
TSoU - The Story of Us
SL - Suburban Legends
SN - Sweet Nothing
ToMG - Teardrops on My Guitar
TMW - Tell Me Why
TYA - Thank You Aimee
TW - Thats When
TIMT - This Is Me Trying
TIWYCF - This Is What You Came For
TIWWCHNT - This Is Why We Cant Have Nice Things
TL - This Love
TTwaS - Tied Together with a Smile
TM - Tim McGraw
TtDS - Tis the Damn Season
TI - Tolerate It
TTPD - The Tortured Poets Department
TVFN - The Very First Night
VS - Vigilante Shit
TWILY - The Way I Loved You
WANEGBT - We Are Never Ever Getting Back Together
WtNY - Welcome to New York
WWH - We Were Happy
WEFiL - When Emma Falls in Love
WC - White Christmas
WH - White Horse
WAoLOM - Whos Afraid of Little Old Me
WD - Wildest Dreams
WCS - Wouldve Couldve Shouldve
YAOM - You All Over Me
YAiL - You Are in Love
YBwM - You Belong with Me
YNtCD - You Need to Calm Down
YNS - Youre Not Sorry
YoYOK - Youre on Your Own Kid
ALMLY - A Little More Like You
BB - Baby Blue
BD - Beautiful Days
GS - Gails Song
GS - Go Slow
HtT - HalfWay to Texas
HR - Houston Rodeo
IUtF - I Used to Fly
MJ - Mary Jo
MTtBM - My Turn to Be Me
NF - Never Fade
OMD - One More Day
OG - OneSided Goodbye
PoV - Point of View
RO - Ride On
SG - Same Girl
TL - Thats Life
WDYS - What Do You Say
YWA - You Walk Away
YP - Your Picture
